NO ./images/kyle.xpm
SO ./images/demon.xpm
WE ./images/cartman.xpm
EA ./images/kenny.xpm

F 118,00,0
C 22,230,70                  

1
111
1111
11N1
1111 





1111111111
