NO ./images/disney.xpm
SO ./images/dreamworks.xpm
WE ./images/forest.xpm
EA ./images/pixar.xpm

F 220   ,     100   , 0 
C 225,30,0                  

 

1
111
11111
11N1  111
1111  111111






111
