NO fjhsdf ./hello
SO	aidj3r23rf    	./ici
WE ../lol/Makefile
EA./jfjsdfh

C fbhsdf 200, 200, 200
F fsjnfns 0,0,0

1111111111111111111111111111
1000000000100000000000100001
1000000000000000000000000001
1000001111111101100000011111
1111111111111111111111111111
